|raw|file
de|delta_lake|around
write|write_deltalake|around
duck|duckdb|around
|movie_data|file
d|delta_lake|around
d|duckdb|around
setup_|setup_logging|around
datetime|datetime|around
l|logger|around
par|parameter_store|around
|config|file
get|get_keys|around
|config.yaml|file
pa|parameter_store|around
que|question|around
use|use|around
docuents|documents|around
get|get_documents|around
G|GPTSimpleVectorIndex|around
SimpleDi|SimpleDirectoryReader|around
inb|inbound|around
my_sa|my_sample|around
config|config_data|around
con|config_location|around
file|file_type|around
po|polybarright|around
fi|fish|file
expr|export|around
|share|file
e|exports|file
flat|flatpak|file
expo|exports|file
f|flatpak|file
|screen-auto-rotate|file